

11111111111111
10C11000001C01
10110001001001
10000111101101
1P0011E0000001
11111111111111

kfp
fwefg
gergr
erg
