11111111111111111111
10C1C01C000000001C01
1011101100011C011001
10011000011111000011
10010011001110000001
1000001100C1000100C1
10P0000111110C110111
1011100C011000110011
10111000000000110001
1001100011E000000101
10C111011111011011C1
11111111111111111111
