1111111111111111111111111111111111
1111111111111111111111111111111111
1001110C0000000C000010011100111111
100011011001100110001C000100110011
11100101101110011C1011110000010111
1110000000011000111001111110000111
1110011000000000011001111000000111
1100011110110010000001110000111111
110001000001101C000001000010011111
100P000110000011100100000110010011
100001011C00C00000E11000C1110000C1
1111111111111110111111111111111111
1000000000000000000000000000000001
1000000000000000000000000000000001
1111111111111111111111111111111111
