11111111111111111111111
11010101010101010101011
10101010101010101010101
11010101010101010101011
1010101C10101C101010101
1101011C11011C110101011
1010101C10101C101010101
1101011C11C11C110101011
1010101CCCPCCC101010101
1101011C11E11C110101011
1010101C10101C101010101
1101011C11011C110101011
1010101C10101C101010101
11010101010101010101011
10101010101010101010101
11010101010101010101011
11111111111111111111111
