11111111111111
10C11000001C01
10110001001001
10000111101101
1P001100000001
11111111111111
