1111111111111
1010101010101
1111111111111
10101CEP10101
1111111111111
1010101010101
1111111111111
