


11111111111111
10011000001001
10110001001001
10000101101101
10001100000001
11111111111111

